1 1 1 1 1 1 1 1 1 1 1 1 1 1 1 1 1 1 1 1 1 1 1 1 1 1 
1 4 9 2 0 0 1 2 0 1 0 0 4 9 2 0 1 0 0 0 0 2 0 0 0 1 
1 9 9 9 1 1 0 9 2 0 0 0 9 9 9 1 0 0 0 0 0 9 0 0 0 1 
1 0 0 9 0 0 0 9 9 0 0 0 0 0 9 1 1 3 9 9 0 9 0 0 0 1 
1 0 0 0 0 0 2 0 9 0 4 9 0 3 9 9 0 9 9 9 4 9 0 0 0 1 
1 0 0 0 0 2 9 0 0 0 9 9 0 9 9 9 0 9 9 9 9 9 0 0 0 1 
1 0 1 0 0 9 9 0 0 0 1 0 0 9 9 9 0 0 0 0 4 9 0 0 0 1 
1 0 0 0 1 9 0 0 0 0 0 0 4 9 0 0 0 0 0 0 9 9 0 0 0 1 
1 0 1 0 0 1 3 9 9 0 0 0 9 9 0 0 2 0 1 3 9 9 1 0 0 1 
1 3 9 9 0 0 9 9 9 3 9 9 0 0 0 0 9 0 0 9 9 9 0 0 0 1 
1 9 9 9 0 0 9 9 9 9 9 9 0 0 0 0 9 0 0 9 9 9 1 0 0 1 
1 9 9 9 0 0 0 4 9 9 9 9 0 1 1 0 1 0 0 2 0 0 0 0 0 1 
1 0 0 0 0 0 0 9 9 0 0 0 0 0 0 0 0 0 0 9 0 0 0 0 0 1 
1 0 0 0 0 0 0 0 0 0 0 0 0 0 0 0 0 0 0 9 0 0 0 0 0 1 
1 1 1 1 1 1 1 1 1 1 1 1 1 1 1 1 1 1 1 1 1 1 1 1 1 1 
